2, 0, 0, 0, 0, 5, 3, 0, 0, 6
0, 1, 1, 0, 0, 0, 0, 0, 0, 0
0, 1, 1, 0, 5, 0, 0, 0, 1, 0
0, 0, 0, 3, 0, 3, 0, 0, 0, 5
3, 0, 0, 0, 3, 0, 0, 0, 0, 0
5, 5, 5, 0, 0, 1, 0, 0, 2, 0
9, 0, 0, 0, 3, 0, 0, 0, 0, 0
0, 0, 0, 0, 0, 0, 0, 0, 0, 0
0, 0, 0, 0, 0, 2, 0, 5, 0, 0
0, 0, 3, 0, 0, 0, 0, 0, 3, 0