0, 0, 4, 0, 9, 8, 0, 4, 0, 0
0, 0, 0, 0, 0, 0, 0, 0, 0, 0
4, 0, 0, 0, 0, 0, 0, 0, 0, 4
0, 0, 0, 0, 0, 0, 0, 0, 0, 0
3, 0, 0, 0, 3, 3, 0, 0, 0, 3
3, 0, 0, 0, 3, 3, 0, 0, 0, 3
0, 0, 0, 0, 0, 0, 0, 0, 0, 0
4, 0, 0, 0, 0, 0, 0, 0, 0, 4
0, 0, 0, 0, 0, 0, 0, 0, 0, 0
6, 0, 4, 0, 3, 3, 0, 4, 0, 7