4, 4, 4, 4, 4, 4, 4, 4, 4, 4
4, 4, 4, 4, 4, 4, 4, 4, 4, 4
4, 4, 4, 4, 4, 4, 4, 4, 4, 4
4, 4, 4, 4, 4, 4, 4, 1, 4, 2
4, 4, 4, 4, 1, 1, 1, 1, 0, 1
4, 4, 4, 4, 1, 6, 0, 0, 0, 0
4, 4, 4, 4, 1, 0, 0, 0, 0, 0
4, 4, 4, 1, 1, 0, 0, 0, 0, 0
4, 4, 4, 4, 0, 0, 0, 0, 0, 0
4, 4, 4, 2, 1, 0, 0, 0, 0, 9