2, 3, 5, 0, 6, 1, 0, 0, 0, 0
0, 0, 0, 0, 0, 0, 0, 3, 0, 0
0, 0, 0, 0, 0, 0, 3, 0, 0, 0
0, 0, 0, 0, 0, 0, 0, 0, 0, 0
1, 0, 4, 0, 0, 0, 0, 0, 0, 9
7, 0, 0, 4, 0, 0, 0, 0, 0, 1
0, 0, 0, 0, 0, 0, 0, 0, 0, 0
0, 0, 0, 0, 0, 0, 0, 0, 0, 0
0, 0, 0, 0, 0, 0, 0, 0, 0, 0
0, 0, 0, 2, 1, 8, 0, 0, 0, 5