1, 5, 5, 8, 5, 5, 7, 5, 5, 1
0, 0, 0, 0, 3, 3, 0, 0, 0, 0
0, 0, 0, 0, 4, 4, 0, 0, 0, 0
2, 0, 0, 0, 3, 3, 0, 0, 0, 2
4, 3, 4, 3, 0, 0, 3, 4, 3, 4
4, 3, 4, 3, 0, 0, 3, 4, 3, 4
2, 0, 0, 0, 3, 3, 0, 0, 0, 2
0, 0, 0, 0, 4, 4, 0, 0, 0, 0
0, 0, 0, 0, 3, 3, 0, 0, 0, 0
1, 5, 5, 9, 5, 5, 6, 5, 5, 1