5, 0, 0, 0, 0, 0, 1, 0, 0, 5
0, 0, 0, 0, 0, 3, 0, 0, 0, 0
0, 0, 0, 0, 3, 0, 0, 0, 0, 0
5, 0, 0, 0, 0, 0, 0, 1, 0, 5
0, 0, 0, 3, 3, 3, 0, 0, 0, 0
5, 3, 0, 2, 2, 2, 0, 0, 3, 5
1, 0, 0, 0, 2, 2, 0, 3, 0, 1
0, 0, 0, 0, 0, 2, 0, 0, 0, 0
3, 3, 3, 0, 0, 3, 0, 0, 0, 0
8, 7, 6, 5, 5, 5, 1, 0, 9, 0