0, 0, 0, 1, 1, 1, 1, 1, 0, 5
0, 0, 0, 1, 4, 4, 4, 1, 0, 0
0, 0, 0, 1, 4, 4, 4, 1, 0, 0
0, 0, 0, 1, 4, 1, 1, 1, 0, 0
2, 0, 0, 0, 0, 0, 0, 0, 6, 0
0, 0, 0, 0, 0, 0, 0, 0, 0, 2
0, 0, 0, 0, 0, 0, 0, 0, 0, 0
0, 0, 0, 0, 0, 0, 0, 0, 0, 0
0, 0, 0, 0, 0, 0, 0, 0, 0, 0
0, 0, 0, 0, 0, 0, 0, 0, 0, 9