4, 0, 0, 0, 5, 4, 4, 3, 4, 4
0, 0, 0, 0, 4, 4, 4, 4, 4, 4
0, 1, 0, 0, 4, 4, 4, 4, 4, 3
0, 0, 0, 0, 0, 4, 4, 4, 4, 4
0, 0, 0, 0, 0, 9, 4, 4, 4, 4
0, 0, 0, 0, 6, 0, 0, 4, 4, 5
0, 0, 0, 0, 0, 0, 0, 2, 0, 0
0, 0, 1, 0, 0, 0, 0, 0, 0, 0
0, 0, 0, 0, 0, 0, 0, 5, 0, 0
0, 0, 0, 0, 0, 0, 0, 0, 0, 0