0, 0, 0, 0, 0, 0, 0, 0, 0, 0
0, 1, 1, 0, 4, 4, 0, 9, 0, 0
0, 1, 1, 4, 4, 4, 0, 0, 4, 4
0, 1, 0, 0, 4, 4, 0, 0, 4, 0
0, 1, 1, 1, 1, 1, 0, 3, 4, 3
0, 1, 1, 1, 1, 1, 0, 0, 5, 3
0, 0, 0, 0, 0, 0, 0, 2, 4, 5
3, 0, 0, 0, 0, 0, 0, 0, 4, 0
0, 0, 0, 0, 0, 0, 0, 0, 4, 0
0, 0, 0, 0, 0, 0, 0, 6, 4, 5