5, 5, 5, 5, 5, 5, 5, 5, 5, 5
5, 0, 0, 0, 1, 0, 0, 0, 0, 5
5, 1, 0, 0, 6, 0, 0, 0, 1, 5
5, 0, 0, 0, 0, 0, 0, 0, 0, 5
5, 0, 0, 0, 0, 0, 0, 0, 0, 5
5, 0, 0, 0, 0, 0, 0, 0, 0, 5
5, 0, 0, 1, 9, 0, 0, 7, 0, 5
5, 0, 0, 0, 0, 0, 0, 1, 0, 5
5, 0, 1, 0, 0, 0, 0, 0, 0, 5
5, 5, 5, 5, 5, 5, 5, 5, 5, 5