4, 4, 4, 4, 4, 4, 4, 4, 4, 4
4, 4, 4, 1, 1, 4, 4, 1, 1, 4
4, 4, 4, 1, 4, 4, 4, 4, 1, 4
4, 1, 4, 4, 4, 4, 4, 4, 4, 4
4, 4, 4, 4, 4, 1, 4, 4, 4, 1
1, 9, 4, 4, 4, 4, 4, 4, 4, 4
4, 4, 4, 4, 4, 4, 4, 4, 4, 4
4, 4, 4, 4, 2, 4, 4, 4, 4, 4
4, 4, 4, 4, 4, 4, 4, 4, 4, 4
4, 4, 4, 4, 4, 1, 4, 4, 4, 6