4, 4, 4, 1, 4, 4, 4, 1, 4, 4
4, 4, 4, 4, 4, 4, 4, 4, 4, 4
1, 4, 4, 4, 4, 4, 1, 4, 4, 4
4, 4, 4, 4, 4, 4, 4, 4, 1, 4
4, 4, 4, 4, 8, 9, 4, 4, 4, 4
4, 4, 4, 4, 7, 6, 4, 4, 4, 4
1, 4, 4, 4, 4, 1, 4, 4, 4, 4
4, 4, 4, 4, 4, 4, 4, 4, 4, 4
4, 1, 4, 4, 4, 4, 4, 4, 1, 4
4, 4, 4, 4, 1, 4, 4, 4, 4, 4