2, 4, 4, 4, 4, 4, 0, 0, 0, 9
4, 5, 5, 5, 5, 4, 3, 3, 3, 0
4, 5, 5, 5, 5, 4, 3, 1, 3, 0
4, 5, 5, 3, 2, 4, 3, 1, 3, 0
4, 5, 5, 4, 5, 4, 3, 3, 3, 0
4, 4, 4, 4, 4, 4, 0, 0, 0, 0
0, 0, 1, 0, 1, 1, 1, 1, 0, 0
0, 0, 1, 0, 1, 1, 1, 1, 0, 0
0, 0, 1, 0, 0, 0, 0, 0, 3, 0
6, 7, 0, 0, 0, 0, 0, 0, 0, 1