0, 0, 0, 0, 0, 0, 0, 6, 7, 8
3, 0, 4, 0, 0, 0, 0, 0, 0, 0
0, 0, 2, 0, 0, 0, 0, 0, 0, 0
0, 0, 0, 1, 1, 1, 1, 1, 1, 0
0, 0, 0, 0, 0, 1, 2, 2, 1, 0
0, 0, 0, 0, 0, 0, 0, 0, 0, 0
0, 3, 0, 0, 0, 0, 0, 4, 2, 0
0, 0, 0, 0, 1, 1, 2, 2, 4, 0
0, 0, 0, 0, 1, 0, 0, 0, 0, 0
9, 0, 0, 0, 0, 0, 0, 0, 0, 0