0, 0, 0, 0, 0, 0, 0, 0, 0, 0
0, 0, 0, 0, 0, 0, 0, 0, 0, 0
0, 0, 0, 4, 3, 0, 0, 0, 0, 0
0, 0, 3, 0, 0, 0, 0, 0, 0, 3
0, 0, 4, 0, 0, 0, 0, 0, 0, 0
0, 2, 0, 0, 1, 1, 0, 0, 0, 0
0, 1, 2, 0, 1, 0, 0, 4, 2, 3
0, 1, 1, 0, 0, 0, 0, 0, 0, 0
0, 0, 0, 0, 0, 0, 0, 0, 0, 0
6, 5, 5, 7, 5, 5, 8, 5, 5, 9