0, 0, 0, 0, 0, 0, 0, 0, 0, 0
0, 0, 0, 0, 0, 0, 0, 0, 0, 0
0, 0, 0, 0, 3, 3, 0, 0, 0, 0
0, 0, 0, 3, 3, 3, 3, 0, 0, 6
0, 2, 3, 3, 3, 3, 3, 3, 0, 7
0, 2, 3, 3, 3, 3, 3, 3, 0, 8
0, 0, 0, 3, 3, 3, 3, 0, 0, 9
0, 0, 0, 0, 3, 3, 0, 0, 0, 0
0, 0, 0, 0, 0, 0, 0, 0, 0, 0
0, 0, 0, 0, 0, 0, 0, 0, 0, 0