9, 4, 4, 4, 4, 4, 1, 2, 0, 0
4, 4, 3, 4, 4, 0, 2, 0, 0, 0
4, 3, 2, 4, 4, 0, 0, 0, 0, 2
4, 4, 4, 4, 4, 0, 0, 0, 0, 0
4, 4, 4, 4, 0, 0, 0, 0, 0, 0
4, 0, 0, 0, 0, 0, 0, 0, 0, 0
0, 0, 0, 0, 0, 0, 0, 0, 0, 0
0, 3, 0, 0, 0, 0, 0, 0, 0, 0
0, 0, 2, 0, 0, 0, 0, 0, 0, 0
0, 0, 1, 0, 0, 0, 0, 0, 0, 6