0, 0, 0, 0, 0, 0, 1, 0, 0, 0
0, 0, 0, 2, 0, 0, 0, 0, 0, 0
3, 1, 0, 0, 0, 0, 1, 0, 0, 0
2, 0, 0, 0, 3, 0, 0, 0, 1, 0
3, 0, 0, 0, 3, 0, 9, 1, 1, 0
0, 2, 0, 3, 0, 3, 0, 0, 1, 0
0, 0, 0, 0, 0, 0, 1, 0, 0, 0
0, 0, 0, 0, 3, 0, 2, 0, 0, 3
7, 1, 0, 0, 0, 0, 0, 0, 0, 0
6, 0, 0, 0, 0, 0, 0, 0, 0, 0