6, 0, 0, 3, 5, 3, 0, 0, 0, 9
5, 0, 0, 0, 0, 0, 0, 0, 0, 5
0, 0, 0, 0, 0, 0, 0, 0, 0, 3
0, 0, 0, 0, 0, 0, 0, 0, 0, 0
5, 0, 0, 3, 0, 2, 0, 3, 0, 0
0, 3, 0, 0, 0, 0, 0, 0, 0, 3
0, 0, 0, 0, 0, 3, 0, 3, 0, 0
5, 0, 0, 0, 0, 0, 0, 3, 0, 5
0, 0, 0, 3, 0, 0, 0, 0, 0, 0
1, 0, 0, 3, 0, 0, 0, 0, 0, 7