0, 0, 0, 0, 0, 0, 1, 0, 0, 0
0, 0, 1, 0, 0, 0, 0, 0, 0, 0
0, 0, 0, 0, 0, 0, 4, 0, 1, 0
0, 0, 0, 0, 0, 0, 0, 0, 0, 0
1, 0, 0, 0, 0, 0, 0, 0, 0, 0
0, 0, 0, 0, 5, 3, 0, 2, 3, 4
0, 0, 0, 0, 0, 0, 0, 0, 0, 0
0, 0, 9, 0, 0, 1, 0, 0, 0, 0
0, 0, 5, 0, 0, 0, 0, 0, 0, 0
6, 0, 0, 0, 0, 0, 0, 4, 0, 0