0, 0, 2, 0, 0, 5, 2, 0, 0, 0
0, 0, 0, 0, 0, 0, 0, 0, 0, 0
0, 0, 0, 0, 0, 0, 0, 0, 0, 0
0, 0, 0, 0, 0, 0, 0, 0, 0, 0
2, 0, 2, 1, 0, 0, 7, 0, 0, 0
1, 0, 0, 0, 0, 8, 1, 6, 0, 0
0, 0, 0, 0, 1, 0, 9, 0, 0, 0
0, 0, 0, 0, 0, 0, 0, 0, 0, 0
2, 0, 0, 0, 0, 0, 0, 0, 0, 2
0, 0, 0, 2, 1, 1, 1, 0, 0, 5