2, 0, 0, 0, 0, 0, 0, 0, 0, 0
0, 1, 1, 1, 1, 1, 1, 1, 1, 0
0, 1, 9, 0, 0, 3, 0, 0, 1, 0
3, 0, 0, 4, 4, 4, 4, 0, 1, 0
0, 1, 0, 3, 4, 3, 4, 0, 1, 0
0, 1, 3, 4, 3, 4, 3, 0, 1, 0
0, 1, 0, 2, 4, 4, 4, 0, 0, 3
0, 1, 2, 0, 0, 0, 0, 6, 1, 0
0, 1, 1, 1, 1, 1, 1, 1, 1, 0
0, 0, 0, 0, 0, 0, 0, 0, 0, 2